table Alimentador cols: AlimentadorId SubEstacaoId Codigo Nome 
table Almoxarifado cols: AlmoxarifadoId Nome EmpresaId MunicipioId Centro Deposito SAPNome DataInicio FirmaId NomeResumo 
table Arquivo cols: ArquivoId Nome ArquivoPastaId ArquivoTipoId Tamanho Data Hash Numero DataPasta UsuarioId DataExclusao UsuarioIdExclusao DataExclusaoFisica Referencia 
table ArquivoPasta cols: ArquivoPastaId Nome Pasta Identificador Limitado Tipo Local Bucket KeyId Secret 
table ArquivoStatus cols: ArquivoStatusId ArquivoId ArquivoStatusTipoId Observacao Data UsuarioId DataExclusao UsuarioIdExclusao 
table ArquivoStatusTipo cols: ArquivoStatusTipoId Nome Icone Cor Descricao ArquivoStatusTipoIdRaiz 
table ArquivoTipo cols: ArquivoTipoId Nome Codigo Extensoes ArquivoPastaId Grupo StatusTipoMultiplo Tamanho FirmaId 
table ArquivoTipologia cols: ArquivoTipologiaId Nome Codigo Pasta FirmaId 
table ArquivoTipologiaStatus cols: ArquivoTipologiaStatusId Nome 
table ArquivoTipologiaTipo cols: ArquivoTipologiaTipoId ArquivoTipologiaId ArquivoTipoId DataInicio DataFim 
table ArquivoTipoStatusTipo cols: ArquivoTipoStatusTipoId ArquivoTipoId ArquivoStatusTipoId ObservacaoObrigatorio Grupo 
table Atualizacao cols: AtualizacaoId JobPrioridadeId Data UsuarioId DataCancelado UsuarioIdCancelado DataAtualizacao DataExecucao AtualizacaoTipoId ProjetoId NotaId EmpresaContratoId SAPPedidoId SAPReservaId MaterialId 
table AtualizacaoTipo cols: AtualizacaoTipoId Nome Campo 
table Bairro cols: BairroId Nome MunicipioId 
table BaseConhecimento cols: BaseConhecimentoId Icone Codigo Titulo Data UsuarioId UsuarioIdAlteracao Cor DataLancamento DataAlteracao ArquivoId 
table BaseConhecimentoGrupo cols: BaseConhecimentoGrupoId Role Titulo SubTitulo 
table BaseConhecimentoGrupos cols: BaseConhecimentoId BaseConhecimentoGrupoId 
table CacheQuery cols: CacheQueryId Tipo Hash Tabela DataInicio DataFim DataValidade 
table CadastroDemanda cols: CadastroDemandaId Id Serial Data FirmaId CadastroDemandaHistoricoId CadastroDemandaTipoId NotaId ProjetoId GseProjetoId GseProjetoStatusIdDe GseProjetoStatusIdPara SgsiSolicitacaoIntervencaoId SgsiPermissaoServicoId GseOcorrenciaId ArquivoIdAsbuilt ITNOWChamado ProjetoTermoGeoId UsuarioIdDe UsuarioIdPara Placa Cia NomeSE SiglaSE Alimentador UnidadeId CentroCustoCodigo CentroCustoNome Localidade Bairro MaterialId 
table CadastroDemandaArquivo cols: ArquivoId CadastroDemandaId 
table CadastroDemandaEquipamento cols: CadastroDemandaId CadastroDemandaEquipamentoFabricanteId Cia Serie CadastroDemandaEquipamentoPotenciaId CadastroDemandaEquipamentoTipoMedicaoId CadastroDemandaEquipamentoTensaoATId CadastroDemandaEquipamentoTensaoBTId Endereco PerdasVazio CadastroDemandaEquipamentoClasseIsolacaoId CadastroDemandaEquipamentoNivelBasicoIsolamentoId MunicipioId PerdasCobre CadastroDemandaEquipamentoTapInternoId CadastroDemandaEquipamentoPropriedadeId CadastroDemandaEquipamentoSituacaoId PerdasTotais CadastroDemandaEquipamentoLigacaoId CorrenteExcitacao Impedancia Massa Capacidade Fabricacao NotaFiscal CadastroDemandaEquipamentoIsolanteId CadastroDemandaEquipamentoIsolanteTipoId EmpresaReformadora 
table CadastroDemandaEquipamentoClasseIsolacao cols: CadastroDemandaEquipamentoClasseIsolacaoId Nome 
table CadastroDemandaEquipamentoFabricante cols: CadastroDemandaEquipamentoFabricanteId Nome 
table CadastroDemandaEquipamentoIsolante cols: CadastroDemandaEquipamentoIsolanteId Nome 
table CadastroDemandaEquipamentoIsolanteTipo cols: CadastroDemandaEquipamentoIsolanteTipoId Nome 
table CadastroDemandaEquipamentoLigacao cols: CadastroDemandaEquipamentoLigacaoId Nome 
table CadastroDemandaEquipamentoNivelBasicoIsolamento cols: CadastroDemandaEquipamentoNivelBasicoIsolamentoId Nome 
table CadastroDemandaEquipamentoPotencia cols: CadastroDemandaEquipamentoPotenciaId Nome 
table CadastroDemandaEquipamentoPropriedade cols: CadastroDemandaEquipamentoPropriedadeId Nome 
table CadastroDemandaEquipamentoSituacao cols: CadastroDemandaEquipamentoSituacaoId Nome 
table CadastroDemandaEquipamentoTapInterno cols: CadastroDemandaEquipamentoTapInternoId Nome CadastroDemandaEquipamentoTensaoATId 
table CadastroDemandaEquipamentoTensaoAT cols: CadastroDemandaEquipamentoTensaoATId Nome 
table CadastroDemandaEquipamentoTensaoBT cols: CadastroDemandaEquipamentoTensaoBTId Nome 
table CadastroDemandaEquipamentoTipoMedicao cols: CadastroDemandaEquipamentoTipoMedicaoId Nome 
table CadastroDemandaHistorico cols: CadastroDemandaHistoricoId CadastroDemandaId HistoricoStatusId Data UsuarioId Retroagido Excluido 
table CadastroDemandaItem cols: CadastroDemandaItemId CadastroDemandaId CadastroDemandaMaterialTipoId PG1 PG2 MaterialId Id Placa Observacao Cia Barramento Pedido CadastroDemandaEquipamentoFabricanteId Serie Fabricacao Rejeitado Alimentador 
table CadastroDemandaMaterialTipo cols: CadastroDemandaMaterialTipoId Nome 
table CadastroDemandaObservacao cols: CadastroDemandaObservacaoId CadastroDemandaId Texto HistoricoStatusId Retroagido Data UsuarioId 
table CadastroDemandaProjetoAssociado cols: CadastroDemandaId ProjetoId 
table CadastroDemandaTipo cols: CadastroDemandaTipoId Nome NomeArvore CadastroDemandaTipoIdParente Ordem 
table CadernoServico cols: CadernoServicoId Nome DataInicio DataFim Ida Volta Distancia Tonelada Data UsuarioId DataAtualizacao UsuarioIdAtualizacao FirmaId 
table CampoTipo cols: CampoTipoId Nome 
table CarteiraFiscalizacao cols: CarteiraFiscalizacaoId Id CarteiraFiscalizacaoIdParente Data ProjetoId ReferenciaProcesso UnidadeId MunicipioId Frente CarteiraFiscalizacaoCategoriaId NumeroReferenciaFiscalizacao DataFiscalizacao CarteiraFiscalizacaoHistoricoId CarteiraFiscalizacaoHistoricoIdUsuarioDirecionado FirmaId Serial Tipo Processo NotaId 
table CarteiraFiscalizacaoArquivo cols: ArquivoId CarteiraFiscalizacaoId 
table CarteiraFiscalizacaoCategoria cols: CarteiraFiscalizacaoCategoriaId Nome 
table CarteiraFiscalizacaoHistorico cols: CarteiraFiscalizacaoHistoricoId CarteiraFiscalizacaoId HistoricoStatusId Observacao UsuarioIdDirecionado Data UsuarioId Retroagido Excluido 
table Cep cols: Numero Logradouro Bairro CidadeId 
table Chamado cols: ChamadoId Id ChamadoCategoriaId ChamadoTipoId ChamadoPrioridadeId HistoricoStatusId DataPrevisao Data UsuarioId DataResponsavel UsuarioIdResponsavel DataFinalizado Assunto Serial 
table ChamadoAutorizacao cols: ChamadoAutorizacaoId ChamadoId UsuarioId HistoricoStatusId 
table ChamadoCampo cols: ChamadoCampoId ChamadoId ChamadoCampoTipoId Valor 
table ChamadoCampoTipo cols: ChamadoCampoTipoId ChamadoCategoriaId ChamadoTipoId Nome Descricao Obrigatorio Tipo Opcoes CaixaAlta Min Max Mascara CasasDecimais NumeroGroup AceitarNegativo Ordem OpcoesSql 
table ChamadoCategoria cols: ChamadoCategoriaId Nome NomeArvore ChamadoCategoriaIdParente Ordem Icone Cor IsErro FirmaId 
table ChamadoHistorico cols: ChamadoHistoricoId ChamadoId ChamadoCategoriaId ChamadoTipoId ChamadoPrioridadeId HistoricoStatusId DataPrevisao UsuarioIdResponsavel ChamadoAutorizacaoId Mensagem Data UsuarioId UsuarioIdExtra UsuarioExtraRemovido ChamadoAutorizacaoHistoricoStatusId 
table ChamadoPrioridade cols: ChamadoPrioridadeId Nome Ordem Icone Cor 
table ChamadoResposta cols: ChamadoRespostaId Nome Texto 
table ChamadoTipo cols: ChamadoTipoId Nome Icone Cor ChamadoPrioridadeId TextoPadrao 
table ChamadoUsuario cols: ChamadoId UsuarioId 
table Cidade cols: CidadeId Nome EstadoId InterligaViabilidadeTecnica 
table ClasseCusto cols: ClasseCustoId Nome 
table Cliente cols: ClienteId RG Nome DataNascimento CEP Endereco Bairro Complemento NIS Identificador ClienteOrgaoExpedidorId ClienteAusente MunicipioId ClienteHistoricoId UsuarioSexoId 
table ClienteArquivo cols: ArquivoId ClienteFichaId 
table ClienteClassificacao cols: ClienteClassificacaoId Nome 
table ClienteFicha cols: ClienteFichaId Id Serial Data Contato Whatsapp Email Latitude Longitude Portal Clandestino NotaId ClienteId CEP Endereco Bairro Complemento ClienteClassificacaoId UsuarioEstadoCivilId ClienteFichaHistoricoId Observacao 
table ClienteFichaHistorico cols: ClienteFichaHistoricoId ClienteFichaId HistoricoStatusId UsuarioId Data 
table ClienteHistorico cols: ClienteHistoricoId ClienteId HistoricoStatusId UsuarioId Data 
table ClienteNota cols: ClienteNotaId NotaId DataLiberacao UsuarioId DataExclusao UsuarioIdExclusao 
table ClienteOrgaoExpedidor cols: ClienteOrgaoExpedidorId Nome 
table Configuracao cols: ConfiguracaoId Url EmailSuporte ServicoDescontoPrazoRejeicao EletrobrasUsuario EletrobrasSenha ChamadoPrazoReabrir Proxy SistemaUsuario SistemaSenha PastaTemp JobHistoricoArquivoManterDias UrlServicoBot UrlServicoRelatorio BotWhatsappNumero BotTelegramApi BotTelegramUsuario MicrosoftGraphClientId MicrosoftGraphTenantId MicrosoftGraphSecret BotTeamsAppId BotTeamsAppSecret BotTeamsUsuario UrlServicoWA UrlCliente ADDominio RedeUsuario RedeSenha UrlCADTerceiro BotTelegramAtivo BotTeamsAtivo BotWhatsappAtivo StatusPageSubDomain UrlCdn ChamadoCategoriaIdCadastroUsuario Tipo ArquivoS3Url ArquivoS3UrlFriendly ArquivoS3Bucket ArquivoS3KeyId ArquivoS3Secret SMTPServidor SMTPUsuario SMTPSenha GoogleApiKey GoogleApiUrl CaptchaClientKey CaptchaServerKey 
table Conjunto cols: ConjuntoId Codigo Nome Prioridade 
table DemandaProgramacaoArea cols: DemandaProgramacaoAreaId Nome 
table DemandaProgramacaoTipo cols: DemandaProgramacaoTipoId Nome DemandaProgramacaoAreaId 
table Departamento cols: DepartamentoId Descricao Sigla SetorId 
table ElementoPEP cols: ElementoPEPId Sigla 
table EletrobrasHistoricoStatus cols: EletrobrasHistoricoStatusId Nome 
table EletrobrasModulo cols: EletrobrasModuloId Nome EletrobrasModuloTipoId UnidadeMedidaId 
table EletrobrasModuloItem cols: EletrobrasModuloItemId EletrobrasModuloId EletrobrasTrancheId EletrobrasTrancheTipoId 
table EletrobrasModuloTipo cols: EletrobrasModuloTipoId Nome 
table EletrobrasTranche cols: EletrobrasTrancheId Nome DataInicio DataFim 
table EletrobrasTrancheTipo cols: EletrobrasTrancheTipoId Nome 
table Email cols: EmailId Endereco Template Nome 
table Empresa cols: EmpresaId Nome Codeps LoginIniciais IsNeoenergia PrestaServicoMeioAmbiente 
table EmpresaArquivo cols: ArquivoId EmpresaContratoId EmpresaId 
table EmpresaContrato cols: EmpresaId Contrato Data Descricao DataFim Fornecedor ValorFixado ValorConsumido MediaPlanejada MediaReal MediaProjetado ValorProjecao EmpresaContratoTipoPrestacaoId EmpresaContratoStatusId ZRMDePara ValidadeDe ValidadeAte Valor DataAtualizacao PagamentoCTE FirmaId FirmaIdentificadorId HistoricoStatusIdLiberacao EmpresaContratoTipoId EmpresaContratoAreaId 
table EmpresaContratoArea cols: EmpresaContratoAreaId Nome Data UsuarioId DataAtualizacao UsuarioIdAtualizacao FirmaId 
table EmpresaContratoFaturaCaucao cols: EmpresaContratoFaturaCaucaoId EmpresaContratoId MovimentacaoNumero MovimentacaoAno MovimentacaoLinha Valor Retido CorrecaoMonetariaValor CorrecaoMonetariaData Data DevMovimentacaoNumero DevMovimentacaoAno DevValor 
table EmpresaContratoFornecedor cols: EmpresaContratoFornecedorId Contrato Fornecedor 
table EmpresaContratoItem cols: EmpresaContratoItemId EmpresaContratoId Numero Texto ValorLiquidoPrevisto GrupoMercadoria HistoricoStatusId MaterialId UnidadeMedidaId PrazoEntregaPrevista ServicosLancadosManualmente 
table EmpresaContratoItemBkp cols: EmpresaContratoItemId EmpresaContratoId Numero Texto ValorLiquidoPrevisto GrupoMercadoria HistoricoStatusId MaterialId UnidadeMedidaId PrazoEntregaPrevista ServicosLancadosManualmente 
table EmpresaContratoItemOld cols: EmpresaContratoItemOldId Contrato Codigo FaturamentoZRMItemServicoId FatorK 
table EmpresaContratoItemServico cols: EmpresaContratoItemServicoId EmpresaContratoItemId Numero ServicoAtividadeId UnidadeMedidaId TarifaFiscal QuantidadeSolicitada ValorSolicitado 
table EmpresaContratoItemServicoCondicao cols: EmpresaContratoItemServicoCondicaoId EmpresaContratoItemServicoId ValidadeDe ValidadeAte ValorBruto FatorK ValorLiquido 
table EmpresaContratoMaterialRecebedor cols: EmpresaContratoMaterialRecebedorId EmpresaContratoId MaterialRecebedorId MunicipioId 
table EmpresaContratoParceiro cols: EmpresaContratoParceiroId EmpresaContratoId OrganizacaoCompra SAPParceiroFuncaoId EmpresaId SAPCentroId Sequencia EmpresaIdentificacaoId 
table EmpresaContratoQIT cols: EmpresaContratoQITId Serv DataInicio DataFim IRRF CSLL PIS COFINS INSS ISS Data UsuarioId DataAtualizacao UsuarioIdAtualizacao EmpresaContratoId 
table EmpresaContratoRegraMedicao cols: EmpresaContratoRegraMedicaoId EmpresaContratoId SetorId DepartamentoId UnidadeId PostagemId ProjetoGrupoId ProjetoGrupoItemId MunicipioId EmpresaContratoItemId Data UsuarioId DataExclusao UsuarioIdExclusao 
table EmpresaContratoRegraMedicaoBkp cols: EmpresaContratoRegraMedicaoId EmpresaContratoId SetorId DepartamentoId UnidadeId PostagemId ProjetoGrupoId ProjetoGrupoItemId MunicipioId EmpresaContratoItemId Data UsuarioId DataExclusao UsuarioIdExclusao 
table EmpresaContratoRenovaveisTorre cols: EmpresaContratoRenovaveisTorreId EmpresaContratoId RenovaveisTorreId ContaContabil 
table EmpresaContratoStatus cols: EmpresaContratoStatusId Nome 
table EmpresaContratoTipo cols: EmpresaContratoTipoId Codigo Nome 
table EmpresaContratoTipoPrestacao cols: EmpresaContratoTipoPrestacaoId Nome 
table EmpresaContratoUnidade cols: EmpresaContratoUnidadeId EmpresaContrato UnidadeId 
table EmpresaIdentificacao cols: EmpresaIdentificacaoId EmpresaId Nome SistemaTipo Codigo CNPJ MunicipioId Endereco Telefone Email 
table EmpresaObservacao cols: EmpresaObservacaoId EmpresaContratoId Texto UsuarioId Data EmpresaId 
table EncerramentoOnlineAtividade cols: EncerramentoOnlineAtividadeId Nome 
table EncerramentoOnlineBase cols: EncerramentoOnlineBaseId Serial Nome FirmaId 
table EncerramentoOnlineBaseComponente cols: EncerramentoOnlineBaseId EncerramentoOnlineComponenteId 
table EncerramentoOnlineBaseEmpresaContrato cols: EncerramentoOnlineBaseId EmpresaContratoId 
table EncerramentoOnlineBaseItem cols: EncerramentoOnlineBaseItemId EncerramentoOnlineBaseId ServicoAtividadeId MaterialId 
table EncerramentoOnlineClasse cols: EncerramentoOnlineClasseId Nome 
table EncerramentoOnlineComponente cols: EncerramentoOnlineComponenteId Serial Nome EncerramentoOnlineSubGrupoId EncerramentoOnlineClasseId Fases 
table EncerramentoOnlineComponenteItem cols: EncerramentoOnlineComponenteItemId EncerramentoOnlineComponenteId ServicoAtividadeId MaterialId Quantidade 
table EncerramentoOnlineFamilia cols: EncerramentoOnlineFamiliaId Nome FirmaId Ordem ElementoPEPId SAPMovimentoSaque SAPMovimentoDevolucao 
table EncerramentoOnlineGrupo cols: EncerramentoOnlineGrupoId Serial Nome Ordem EncerramentoOnlineFamiliaId 
table EncerramentoOnlineSubGrupo cols: EncerramentoOnlineSubGrupoId Serial Nome EncerramentoOnlineGrupoId Ordem 
table EnvioPastaItem cols: EnvioPastaItemId Nome Ordem 
table EnvioPastaItemArquivoTipologia cols: EnvioPastaItemId ArquivoTipologiaId 
table Equipamento cols: EquipamentoId Id Cia Serie EquipamentoProprietarioId Denominacao Placa EquipamentoStatusId EquipamentoStatusGTId UnidadeId EmpresaId EquipamentoHistoricoId FirmaId Serial 
table EquipamentoArquivo cols: ArquivoId EquipamentoId 
table EquipamentoHistorico cols: EquipamentoHistoricoId EquipamentoId HistoricoStatusId Data UsuarioId 
table EquipamentoProprietario cols: EquipamentoProprietarioId Nome 
table EquipamentoStatus cols: EquipamentoStatusId Nome 
table EquipamentoStatusGT cols: EquipamentoStatusGTId Nome 
table Erro cols: ErroId Url Titulo Mensagem Requisicao Data UsuarioId Verificado Serial 
table EspelhoNota cols: EspelhoNotaId Id Serial Data Tipo EmpresaContratoId EmpresaIdentificacaoIdPrestador CNPJPrestador RazaoSocialPrestador MunicipioIdPrestador EnderecoPrestador TelefonePrestador EmailPrestador CNPJTomador RazaoSocialTomador MunicipioIdTomador EnderecoTomador TelefoneTomador EmailTomador EspelhoNotaHistoricoId AnoOrcamento ContaContabil OrdemFaturamento Pedido SolicitacaoFaturamento EstadoId ICMSST RenovaveisTorreId ArquivoIdNFeXML 
table EspelhoNotaCST cols: EspelhoNotaCSTId Nome 
table EspelhoNotaHistorico cols: EspelhoNotaHistoricoId EspelhoNotaId HistoricoStatusId Data UsuarioId Retroagido Excluido 
table EspelhoNotaMaterial cols: EspelhoNotaMaterialId EspelhoNotaId MaterialId NCM EspelhoNotaCSTId CFOP Quantidade Valor TemICMSST ICMS IPI DespesasAcessorias 
table EspelhoNotaObservacao cols: EspelhoNotaObservacaoId EspelhoNotaId Texto Data UsuarioId HistoricoStatusId 
table EspelhoNotaProjetoPEP cols: EspelhoNotaId ProjetoPEPId 
table EspelhoNotaServico cols: EspelhoNotaId SimplesNacional ServicoAtividadeId Descricao Quantidade Valor IRRF CSLL PIS COFINS INSS ISS MunicipioIdDevidoISS 
table Estado cols: EstadoId Nome Sigla 
table EstadoFirma cols: EstadoId FirmaId OrdemFaturamento AliquotaICMSST 
table Etiqueta cols: EtiquetaId Nome Cor Icone UsuarioId Data UsuarioIdAlteracao DataAlteracao UsuarioIdResponsavel FirmaId 
table FabricaConcreto cols: FabricaConcretoId Nome Municipio 
table FaturamentoPedido cols: Pedido Item ProjetoId Data Valor Denominacao Usuario 
table FaturamentoPedidoSolicitacao cols: Pedido Item FaturamentoSolicitacaoId Atual 
table FaturamentoPedidoStatus cols: Pedido Item GrupoCompra Contrato Liberado Eliminado 
table FaturamentoPedidoUnidade cols: Pedido Unidade 
table FaturamentoSolicitacao cols: FaturamentoSolicitacaoId FaturamentoSolicitacaoStatusId Data NotaFiscal NotaFiscalData 
table FaturamentoSolicitacaoStatus cols: FaturamentoSolicitacaoStatusId Descricao 
table FaturamentoZRM cols: FaturamentoZRMId Numero CentroCusto UnidadeId Ciclo EmpresaId Data UsuarioId DataValidacao UsuarioIdValidacao DataImportacao UsuarioIdImportacao Contrato ParenteFaturamentoZRMId DataExclusao UsuarioIdExclusao DataPedido UsuarioIdPedido DataArquivado UsuarioIdArquivado FirmaId 
table FaturamentoZRMGrupoAcao cols: FaturamentoZRMGrupoAcaoId Nome PostagemId Tipo ZRMTipo Ordem FaturamentoZRMTipoServicoId 
table FaturamentoZRMGrupoAcaoItem cols: FaturamentoZRMGrupoAcaoItemId FaturamentoZRMGrupoAcaoId Codigo Ordem 
table FaturamentoZRMItemServico cols: FaturamentoZRMItemServicoId Nome 
table FaturamentoZRMObservacao cols: FaturamentoZRMObservacaoId FaturamentoZRMId Texto UsuarioId Data 
table FaturamentoZRMTipoServico cols: FaturamentoZRMTipoServicoId Nome 
table Firma cols: FirmaId Nome EmpresaId Sigla UsuarioFuncaoIdGX UsuarioFuncaoIdGXPendente UsuarioFuncaoIdPF UsuarioFuncaoIdPJ UnidadeId Ativo UsuarioIdRelatorioEnvioPasta UsuarioIdRelatorioProtocoloNotificacao SAPR3ProjetoMascaras 
table FirmaIdentificador cols: FirmaIdentificadorId FirmaId SAPR3Codigo Ativo CNPJ RazaoSocial MunicipioId Endereco Telefone Email 
table FormularioVisitaCampoAcaoAIC cols: FormularioVisitaCampoAcaoAICId Nome Ordem 
table FormularioVisitaCampoDetalhamentoSituacaoAIC cols: FormularioVisitaCampoDetalhamentoSituacaoAICId Nome Ordem 
table FormularioVisitaCampoSituacaoAIC cols: FormularioVisitaCampoSituacaoAICId Nome Ordem 
table GestaoContratosComissao cols: GestaoContratosComissaoId Nome UsuarioId ParenteGestaoContratosComissaoId NomeArvore 
table GifsNotificacao cols: GifsNotificacaoId Numero GifsTipoServicoId EmpresaId Data Fiscal QuantidadeInconformidades NumeroNTFC MunicipioId CartaPunicao 
table GifsTipoServico cols: GifsTipoServicoId Nome 
table GseOcorrencia cols: GseOcorrenciaId Numero NumeroMes Data GseOcorrenciaTipoId MunicipioId GseOcorrenciaStatusId DataNotaReclamacao DataPrevista DataAcionamento DataAceite DataChegada DataConclusao Serial FirmaId 
table GseOcorrenciaItem cols: GseOcorrenciaItemId GseOcorrenciaId Numero ProjetoId Elemento GseOcorrenciaItemStatusId UsuarioIdInfo DataInfo UsuarioIdCadastro DataCadastro UsuarioIdAprovacao DataAprovacao 
table GseOcorrenciaItemStatus cols: GseOcorrenciaItemStatusId Nome 
table GseOcorrenciaStatus cols: GseOcorrenciaStatusId Nome Sigla 
table GseOcorrenciaTipo cols: GseOcorrenciaTipoId Nome 
table GseProjeto cols: GseProjetoId Numero Filho ProjetoId UsuarioId GseProjetoTipoId GseProjetoStatusId StatusData Serial UsuarioIdAnalise FirmaId 
table GseProjetoStatus cols: GseProjetoStatusId Nome 
table GseProjetoTipo cols: GseProjetoTipoId Nome ModulosConstrutivos 
table HistoricoStatus cols: HistoricoStatusId Nome Sigla Icone Cor 
table Icone cols: Nome Brand 
table imSAPR3Movimento cols: SAPMovimentoId Numero Exercicio SAPMovimentoOperacaoId MovimentoOperacao DataDocumento DataLancamento DataEntrada Texto Valor UsuarioId Usuario SAPMovimentoTipoId MovimentoTipo DocumentoReferenciaId 
table imSAPR3Movimento_AUFK cols: Codigo Nome SAPEmpresa 
table imSAPR3Movimento_BSEG cols: COBKDocumentoReferenciaId Linha ServicoAtividadeId ServicoAtividade SAPCentroCustoId CentroCusto SAPContaRazaoId ContaRazao SAPMovimentoOrdemId MovimentoOrdem EmpresaIdentificacaoId EmpresaCodigo 
table imSAPR3Movimento_Contrato cols: Numero EmpresaCodigo SAPEmpresa 
table imSAPR3Movimento_CSKS cols: Codigo SAPEmpresa 
table imSAPR3Movimento_CSKU cols: Codigo Nome 
table imSAPR3Movimento_EKPO cols: SAPPedidoId SAPPedidoItemId Pedido PedidoItem Contrato ContratoItem 
table imSAPR3Movimento_Empresa cols: Id Nome CNPJ 
table imSAPR3Movimento_ESKL cols: PacoteNumero PacoteNumeroPai Linha Sequencia Quantidade Porcentagem 
table imSAPR3Movimento_ESKN cols: Folha Sequencia Projeto 
table imSAPR3Movimento_ESLL cols: PacoteNumero Linha LinhaExterno ServicoAtividadeId ServicoAtividade Texto Quantidade ValorBruto ValorLiquido Distribuicao 
table imSAPR3Movimento_ESSR cols: Folha PacoteNumero 
table imSAPR3Movimento_ITEM cols: SAPMovimentoItemId SAPMovimentoId Numero Item Periodo SAPPedidoItemId SAPPedidoItemLinhaId ProjetoPEPId PRPSObjeto SAPClasseCustoId ClasseCusto Quantidade Valor MaterialId Material UnidadeMedidaId UnidadeMedida DocumentoReferenciaLinha SAPEmpresa 
table imSAPR3Movimento_Material cols: Id Nome UnidadeMedida 
table imSAPR3Movimento_MSEG cols: COBKDocumentoReferenciaId Linha Tipo Centro Deposito Lote UnidadeMedida Reserva ReservaItem DocumentoReferencia 
table imSAPR3Movimento_ProjetoPEP cols: ProjetoSAPCodigo ProjetoPEPSAPCodigo ProjetoMascara ProjetoNumero ProjetoPEP ProjetoPEPObjeto SAPEmpresa ModoIncremento 
table imSAPR3Movimento_RKPF cols: Reserva Recebedor 
table imSAPR3Movimento_ServicoAtividade cols: Id Nome UnidadeMedida TarifaFiscal 
table imSAPR3Movimento_SKB1 cols: SAPEmpresa Codigo Nome 
table imSAPR3Movimento_T003T cols: Sigla Nome 
table imSAPR3Movimento_TJ01T cols: Sigla Nome 
table imSAPR3Movimento_UnidadeMedida cols: Id Sigla Nome 
table imSAPR3Movimento_Usuario cols: Login Nome 
table imSAPR3Movimento_ZTRKPF_RECEB cols: Codigo Nome EmpresaCodigo 
table InconformidadeEMFZ cols: InconformidadeEMFZId Nome Ordem 
table InterligaCaracteristicaEmpreendimento cols: InterligaCaracteristicaEmpreendimentoId Nome Ordem 
table InterligaCurtoCircuitoTipoItem cols: InterligaCurtoCircuitoTipoItemId InterligaProcessoTipoId Nome Grupo Ordem 
table InterligaEmpreendimentoTipo cols: InterligaEmpreendimentoTipoId Nome Ordem 
table InterligaFonteGeracao cols: InterligaFonteGeracaoId Nome 
table InterligaFornecimentoRuralTipo cols: InterligaFornecimentoRuralTipoId Nome Ordem 
table InterligaFornecimentoTipo cols: InterligaFornecimentoTipoId Nome Ordem 
table InterligaInversor cols: InterligaInversorId Fabricante Modelo Potencia 
table InterligaMicrogeracaoTipo cols: InterligaMicrogeracaoTipoId Nome 
table InterligaMotorCaracteristica cols: InterligaMotorCaracteristicaId Nome 
table InterligaMotorPartidaTipo cols: InterligaMotorPartidaTipoId Nome 
table InterligaMotorPolo cols: InterligaMotorPoloId Valor Nome 
table InterligaMotorTipo cols: InterligaMotorTipoId Nome 
table InterligaMotorUnidadePotencia cols: InterligaMotorUnidadePotenciaId Nome 
table InterligaOpcaoTarifaria cols: InterligaOpcaoTarifariaId Nome Ordem 
table InterligaOpcaoTarifariaBT cols: InterligaOpcaoTarifariaBTId Nome Ordem 
table InterligaProcesso cols: InterligaProcessoId Id UsuarioIdCliente Data UsuarioPFId UsuarioPJId FirmaId InterligaProcessoHistoricoId Serial InterligaProcessoTipoId ClienteStatus LocalEmpreendimentoStatus ResponsavelStatus ClienteStatusTexto LocalEmpreendimentoStatusTexto ResponsavelStatusTexto 
table InterligaProcessoCurtoCircuito cols: InterligaProcessoId Observacao InterligaProcessoCurtoCircuitoHistoricoId SolicitacaoStatus DadosStatus ArquivosStatus SolicitacaoStatusTexto DadosStatusTexto Nota 
table InterligaProcessoCurtoCircuitoAnaliseDados cols: InterligaProcessoId Lcc3f Lcc3fassim Lcc2f Lccftmax Lccftmin Z1 Z0 TensaoBase PotenciaBase Alimentador ReleFaseTipo ReleNeutroTipo ReleFaseRTC ReleNeutroRTC ReleFasePickUp ReleNeutroPickUp ReleFaseCurvas ReleNeutroCurvas ReleFaseTimeDial ReleNeutroDial ReleFaseTapInst ReleNeutroTapInst ReleReligamentos ReleSEF 
table InterligaProcessoCurtoCircuitoArquivo cols: ArquivoId InterligaProcessoId 
table InterligaProcessoCurtoCircuitoDados cols: InterligaProcessoId PotenciaTotalTransformacao InterligaSubestacaoTipoId InterligaTensaoMTId InterligaReferenciaEletricaTipoId DadosReferenciaEletrica 
table InterligaProcessoCurtoCircuitoHistorico cols: InterligaProcessoCurtoCircuitoHistoricoId InterligaProcessoId HistoricoStatusId Observacao Data UsuarioId 
table InterligaProcessoCurtoCircuitoTipoItem cols: InterligaProcessoCurtoCircuitoTipoItemId InterligaProcessoId InterligaCurtoCircuitoTipoItemId Marcado 
table InterligaProcessoHistorico cols: InterligaProcessoHistoricoId InterligaProcessoId HistoricoStatusId Observacao Data UsuarioId 
table InterligaProcessoLocalEmpreendimento cols: InterligaProcessoId ExisteContrato EnderecoCep EnderecoLogradouro EnderecoNumero EnderecoComplemento EnderecoBairro EnderecoCidadeId EnderecoPontoReferencia EnderecoLatitude EnderecoLongitude ContaContrato 
table InterligaProcessoProjeto cols: InterligaProcessoId Observacao InterligaProcessoProjetoHistoricoId SolicitacaoStatus SolicitacaoStatusTexto DadosStatus DadosStatusTexto EquipamentosGeradoresStatus EquipamentosGeradoresStatusTexto EquipamentosInversoresStatus EquipamentosInversoresStatusTexto UnidadesPrevistasBTStatus UnidadesPrevistasBTStatusTexto UnidadesPrevistasMTStatus UnidadesPrevistasMTStatusTexto ArquivosStatus Nota 
table InterligaProcessoProjetoArquivo cols: ArquivoId InterligaProcessoId 
table InterligaProcessoProjetoDados cols: InterligaProcessoId InterligaEmpreendimentoTipoId InterligaCaracteristicaEmpreendimentoId UnidadeQuadroColetivo QuantidadeUnidadeConsumidora InterligaFonteGeracaoId InterligaOpcaoTarifariaBTId InterligaOpcaoTarifariaId InterligaTarifaBTId InterligaTarifaId InterligaFornecimentoTipoId InterligaFornecimentoRuralTipoId InterligaTensaoFornecimentoTipoId InterligaTensaoBTId InterligaTensaoMTId InterligaTensaoMTLinhaId InterligaReferenciaEletricaTipoId DadosReferenciaEletrica CargaInstalada DemandaCalculada DemandaContratar DemandaContratada QuantidadeLuminariasPrevistas InterligaSubestacaoTipoId InterligaRedeTipoId CondutorEntrada DisjuntorGeral QuantidadeTransformadores PotenciaTotalTransformacao PotenciaInstaladaGeracaoKW PotenciaInstaladaGeracaoKVA PotenciaDisponibilizada 
table InterligaProcessoProjetoEquipamentoGerador cols: InterligaProcessoProjetoEquipamentoGeradorId InterligaProcessoId Modelo Fabricante Potencia Area Quantidade 
table InterligaProcessoProjetoEquipamentoInversor cols: InterligaProcessoProjetoEquipamentoInversorId InterligaProcessoId InterligaInversorId Modelo Fabricante Potencia Quantidade ProtecaoCC ProtecaoCA 
table InterligaProcessoProjetoHistorico cols: InterligaProcessoProjetoHistoricoId InterligaProcessoId HistoricoStatusId Observacao Data UsuarioId 
table InterligaProcessoProjetoUnidadePrevistaBT cols: InterligaProcessoProjetoUnidadePrevistaBTId InterligaProcessoId BlocoTorre Unidade InterligaEmpreendimentoTipoId InterligaTarifaBTId InterligaFornecimentoTipoId InterligaTensaoBTId Carga Demanda 
table InterligaProcessoProjetoUnidadePrevistaMT cols: InterligaProcessoProjetoUnidadePrevistaMTId InterligaProcessoId BlocoTorre Unidade InterligaEmpreendimentoTipoId NotaId InterligaProcessoIdReferencia InterligaTensaoMTId Carga Demanda 
table InterligaProcessoTipo cols: InterligaProcessoTipoId Nome Descricao Prazo Ativo ViabilidadeTecnica CurtoCircuito Projeto Sigla 
table InterligaProcessoViabilidadeTecnica cols: InterligaProcessoId Observacao InterligaProcessoViabilidadeTecnicaHistoricoId SolicitacaoStatus DadosStatus EquipamentosStatus UnidadesPrevistasStatus ArquivosStatus SolicitacaoStatusTexto DadosStatusTexto EquipamentosStatusTexto UnidadesPrevistasStatusTexto Nota 
table InterligaProcessoViabilidadeTecnicaArquivo cols: ArquivoId InterligaProcessoId 
table InterligaProcessoViabilidadeTecnicaDados cols: InterligaProcessoId InterligaReferenciaEletricaTipoId DadosReferenciaEletrica GeracaoProducao InterligaFonteGeracaoId InterligaMicrogeracaoTipoId CargaInstalada InterligaTensaoBTId InterligaTensaoMTId PotenciaTotalTransformacao DemandaContratar DemandaExistente 
table InterligaProcessoViabilidadeTecnicaEquipamento cols: InterligaProcessoViabilidadeTecnicaEquipamentoId InterligaProcessoId InterligaViabilidadeTecnicaEquipamentoTipoId Quantidade PotenciaNominal PotenciaCurtoCircuito FatorPotencia PotenciaMaximaCurtaDuracao PotenciaBancoCapacitoresCompensacaoReator CorrenteMaximaCurtoCircuito DispositivoLimitacaoCorrenteMaximaCurtoCircuito InterligaTensaoBTId OscilacoesPorCiclo NumeroFases MotorFabricante MotorModelo InterligaMotorUnidadePotenciaId InterligaMotorTipoId InterligaMotorPoloId CorrentePartidaIp RelacaoIpIn FatorPotenciaPlenaCarga FatorPotencia75Carga FatorPotencia50Carga RendimentoPlenaCarga Rendimento75Carga Rendimento50Carga ConjugadoNominal ConjugadoPartida ConjugadoMaximo ConjugadoResistenciaCarga MomentoInercia InterligaMotorPartidaTipoId InterligaMotorCaracteristicaId QuantidadePartidasPorDia 
table InterligaProcessoViabilidadeTecnicaHistorico cols: InterligaProcessoViabilidadeTecnicaHistoricoId InterligaProcessoId HistoricoStatusId Observacao Data UsuarioId 
table InterligaProcessoViabilidadeTecnicaTipoItem cols: InterligaProcessoViabilidadeTecnicaTipoItemId InterligaProcessoId InterligaViabilidadeTecnicaTipoItemId Marcado 
table InterligaProcessoViabilidadeTecnicaUnidadePrevista cols: InterligaProcessoViabilidadeTecnicaUnidadePrevistaId InterligaProcessoId InterligaViabilidadeTecnicaUnidadePrevistaTipoId Quantidade FaixaSalarialInicialMaiorQue FaixaSalarialInicial FaixaSalarialFinalMaiorQue FaixaSalarialFinal 
table InterligaRedeTipo cols: InterligaRedeTipoId Nome Ordem 
table InterligaReferenciaEletricaTipo cols: InterligaReferenciaEletricaTipoId Nome 
table InterligaSubestacaoTipo cols: InterligaSubestacaoTipoId Nome 
table InterligaTarifa cols: InterligaTarifaId Nome Ordem 
table InterligaTarifaBT cols: InterligaTarifaBTId Nome Ordem 
table InterligaTensaoBT cols: InterligaTensaoBTId Nome Ordem 
table InterligaTensaoFornecimentoTipo cols: InterligaTensaoFornecimentoTipoId Nome Ordem 
table InterligaTensaoMT cols: InterligaTensaoMTId Nome Ordem 
table InterligaTensaoMTLinha cols: InterligaTensaoMTLinhaId Nome Ordem 
table InterligaUsuario cols: UsuarioId ResponsavelTecnico InterligaUsuarioTituloProfissionalId InterligaUsuarioRegistroEntidadeId RegistroNumero RegistroEstadoId NumeroParceiroNegocios InterligaUsuarioHistoricoId 
table InterligaUsuarioArquivo cols: ArquivoId UsuarioId 
table InterligaUsuarioHistorico cols: InterligaUsuarioHistoricoId UsuarioId HistoricoStatusId Observacao Data UsuarioIdCriado 
table InterligaUsuarioPFUsuarioPJ cols: InterligaUsuarioPFUsuarioPJId DirecaoPFParaPJ UsuarioPFId UsuarioPJId DataAceite Data DataExclusao UsuarioIdExclusao 
table InterligaUsuarioRegistroEntidade cols: InterligaUsuarioRegistroEntidadeId Nome Sigla Ordem 
table InterligaUsuarioRepresentanteLegal cols: InterligaUsuarioRepresentanteLegalId UsuarioId Nome CPF 
table InterligaUsuarioTituloProfissional cols: InterligaUsuarioTituloProfissionalId Nome Ordem 
table InterligaViabilidadeTecnicaEquipamentoTipo cols: InterligaViabilidadeTecnicaEquipamentoTipoId Nome 
table InterligaViabilidadeTecnicaTipoItem cols: InterligaViabilidadeTecnicaTipoItemId InterligaProcessoTipoId Nome Grupo Ordem CidadeVerificar 
table InterligaViabilidadeTecnicaUnidadePrevistaTipo cols: InterligaViabilidadeTecnicaUnidadePrevistaTipoId Nome FaixaSalarialMinimaInicial FaixaSalarialMinimaFinal 
table Job cols: JobId Nome Cron JobPrioridadeId Ativo Data UsuarioId JobCategoriaId JobTipoId ManterHistorico Sql Arquivo ArquivoRede TipoClasse LimiteRegistros JobImportacaoTipoId WebTitulo Web WebDetalhe WebLink WebIcone WebTipo WebFixo WebFixoInicioDias Bot EmailAssunto EmailPreview Email ExportacaoSaidaTipo FirmaId EmailIdSender 
table JobAcao cols: JobAcaoId JobId JobIdExecutar JobStatusId SomenteAutomatico 
table JobCategoria cols: JobCategoriaId Nome Ordem FirmaId 
table JobHistorico cols: JobHistoricoId JobId DataInicio DataFim JobStatusId Mensagem Data UsuarioId DataReferencia Mutex ArquivoExiste JobTipoId DadosExtra 
table JobHistoricoNotificacaoAnexo cols: JobHistoricoNotificacaoAnexoId JobHistoricoId Nome Relatorio Web Whatsapp Email Teams Telegram 
table JobHistoricoNotificacaoEnvio cols: JobHistoricoNotificacaoEnvioId JobHistoricoId UsuarioId Nome Email Whatsapp TelegramId WebJobStatusId WebLido TelegramJobStatusId WhatsappJobStatusId EmailJobStatusId EmailSalvarMime EmailMimeArquivoId WebData TelegramData WhatsappData EmailData TeamsJobStatusId TeamsData TeamsId 
table JobHistoricoNotificacaoEnvioTag cols: JobHistoricoNotificacaoEnvioTagId JobHistoricoNotificacaoEnvioId Nome Valor IsHtml 
table JobHistoricoNotificacaoTag cols: JobHistoricoNotificacaoTagId JobHistoricoId Nome Valor IsHtml 
table JobImportacaoTipo cols: JobImportacaoTipoId Nome Tabela Sql Encoding Delimiter StartCell FirmaId DataInicio DataInicioEmHora ModoDebug 
table JobImportacaoTipoAtualizacao cols: JobImportacaoTipoAtualizacaoId JobImportacaoTipoId DataInicio DataFim DataExecucao FirmaId 
table JobImportacaoTipoColuna cols: JobImportacaoTipoColunaId JobImportacaoTipoId BancoNome BancoTipo BancoSqlConversao ArquivoNome ArquivoPosicao ArquivoLarguraFixaInicio ArquivoLarguraFixaTamanho 
table JobNotificacao cols: JobNotificacaoId Nome JobId Ativo Ordem ParenteJobNotificacaoId Sistema NomeArvore TipoGX TipoPF TipoPJ 
table JobNotificacaoAnexo cols: JobNotificacaoAnexoId JobId Nome Relatorio RelatorioParametros Web Bot Email FileId 
table JobNotificacaoFiltro cols: JobNotificacaoFiltroId JobId Grupo EmpresaId UnidadeId UsuarioFuncaoId UsuarioId Excluir 
table JobPrioridade cols: JobPrioridadeId Nome 
table JobStatus cols: JobStatusId Nome Fim 
table JobTipo cols: JobTipoId Nome Icone 
table JogoMovimento cols: JogoMovimentoId Tipo TipoEspelho 
table JogoStatus cols: JogoStatusId Descricao Sigla Ordem 
table LiberacaoTemporaria cols: LiberacaoTemporariaId Id Serial DataInicio DataFim Justificativa Data UsuarioId DataRevogacao UsuarioIdRevogacao UsuarioIdPara EmpresaIdPara 
table LiberacaoTemporariaPlanoFamilia cols: LiberacaoTemporariaId PlanoFamiliaId DataReferencia 
table LiberacaoTemporariaProjetoArquivo cols: LiberacaoTemporariaId ProjetoId ArquivoTipoId 
table LiberacaoTemporariaProjetoEnvioPasta cols: LiberacaoTemporariaId ProjetoId 
table LiberacaoTemporariaProjetoMedicao cols: LiberacaoTemporariaId ProjetoId PostagemId 
table LiberacaoTemporariaProjetoTermoGeo cols: LiberacaoTemporariaId ProjetoId 
table Localidade cols: LocalidadeId Descricao UnidadeId MunicipioId 
table MapaRota cols: MapaRotaId Data SAPDepositoIdDe ProjetoIdDe SAPDepositoIdPara ProjetoIdPara Distancia 
table Material cols: MaterialId Id Nome UnidadeMedidaId EncerramentoOnlineFamiliaId Concreto Sucata Data DataAtualizacao MaterialIdPara MaterialIdParaFinal 
table MaterialAvaliacao cols: MaterialAvaliacaoId MaterialId SAPLoteId Data PrecoMedioMovel 
table MaterialDePara cols: MaterialDeParaId MaterialIdDe MaterialIdPara Final 
table MaterialMovimento cols: MaterialMovimentoId MaterialMovimentoTipoId MaterialRequisicaoId AlmoxarifadoId ProjetoPEPId UsuarioId Data TurmaCampoId SAPCentroId SAPDepositoId 
table MaterialMovimentoItem cols: MaterialMovimentoItemId MaterialMovimentoId MaterialRequisicaoItemId Quantidade Valor MaterialId 
table MaterialMovimentoTipo cols: MaterialMovimentoTipoId Nome Codigo 
table MaterialRecebedor cols: MaterialRecebedorId Codigo Nome EmpresaId 
table MaterialRequisicao cols: MaterialRequisicaoId MaterialRequisicaoTipoId Id Serial EmpresaId AlmoxarifadoIdOrigem ProjetoIdOrigem TurmaCampoIdOrigem AlmoxarifadoIdDestino ProjetoIdDestino TurmaCampoIdDestino NecessitaAprovacao Data FirmaId MaterialRequisicaoHistoricoId SAPCentroIdOrigem SAPCentroIdDestino SAPDepositoIdOrigem SAPDepositoIdDestino 
table MaterialRequisicaoHistorico cols: MaterialRequisicaoHistoricoId MaterialRequisicaoId HistoricoStatusId Data UsuarioId 
table MaterialRequisicaoItem cols: MaterialRequisicaoItemId MaterialRequisicaoId MaterialId RequisitadoValor Item ElementoPEPId RequisitadoQuantidade AprovadoQuantidade AprovadoValor SeparadoQuantidade SeparadoValor DespachadoQuantidade DespachadoValor RecebidoQuantidade RequisitadoValorTotal AprovadoValorTotal SeparadoValorTotal DespachadoValorTotal 
table MaterialRequisicaoObservacao cols: MaterialRequisicaoObservacaoId MaterialRequisicaoId Texto HistoricoStatusId Data UsuarioId 
table MaterialRequisicaoTipo cols: MaterialRequisicaoTipoId Nome Interno Ordem 
table MedicaoFechamento cols: MedicaoFechamentoId Parcial DataInicio DataFim Data UsuarioId FirmaId 
table MedicaoOrigemDestino cols: MedicaoOrigemDestinoId Nome 
table MetaUnitDiaria cols: MetaUnitDiariaId Dia Ano Multiplicador 
table Municipio cols: MunicipioId Nome NomeSAPR3 NomeGSE NomeSAPCCS EstadoId 
table MunicipioFirma cols: MunicipioId FirmaId Enderecamento UnidadeId Poligonal Universalizacao 
table Nota cols: NotaId Numero DataCriacao FirmaId DataAtualizacao NotaTipoId NotaClienteId UsuarioIdNotificador NotaGrupoCodeId NotaMedidaIdProgramacaoCarteira NotaCodeId NotaStatusTipoId NotaStatusTipoIdUsuario NotaInstalacaoId UsuarioId EnderecoMunicipioId EnderecoRua EnderecoBairro EnderecoCep EnderecoNumero NotaTensaoFornecimentoId CategoriaTarifaria CargaInstalada NotaMedidaIdUltima NotaMedidaIdUltimaNaoFinalizada DemandaDeclarada DuracaoObraDias NotaLigacaoId NotaId_Viabilidade 
table NotaArquivo cols: ArquivoId NotaId 
table NotaCliente cols: NotaClienteId Numero Nome FirmaId 
table NotaCode cols: NotaCodeId Sigla 
table NotaGrupoCode cols: NotaGrupoCodeId Sigla 
table NotaInstalacao cols: NotaInstalacaoId Instalacao Rua Bairro Cep Numero FirmaId MunicipioId 
table NotaLigacao cols: NotaLigacaoId Numero FirmaId NotaId_AnaliseProjeto NotaId_Cadastro NotaId_Obra NotaId_NovaLigacao NotaId_Modificacao1 NotaId_Modificacao2 
table NotaMedida cols: NotaMedidaId NotaId Numero NotaGrupoCodeId Texto Data UsuarioId DataAtualizacao UsuarioIdAtualizacao DataPlanejamentoInicio DataPlanejamentoFim DataConclusao UsuarioIdConclusao NotaCodeId 
table NotaMedidaTexto cols: NotaMedidaId Posicao Texto 
table NotaStatus cols: NotaStatusId NotaId NotaStatusTipoId Flutuante Data UsuarioId DataExclusao UsuarioIdExclusao 
table NotaStatusTipo cols: NotaStatusTipoId Nome Sigla Grupo Ordem Prioridade Icone Cor 
table NotaTensaoFornecimento cols: NotaTensaoFornecimentoId Numero Nome FirmaId 
table NotaTipo cols: NotaTipoId Codigo Nome 
table PedidoTipoMedicao cols: PedidoTipoMedicaoId Descricao Ordem 
table PedidoTipoServico cols: PedidoTipoServicoId Descricao Ordem 
table Permissao cols: PermissaoId Nome Role ParentePermissaoId Ordem Ativo OrdemGeral Tipo AtivoArvore FirmaId 
table PermissaoGrupo cols: PermissaoGrupoId ParenteRole Nome Role Ordem 
table PermissaoMenu cols: PermissaoId Tipo Icone Privado RelatorioDescricao Link LinkExterno Atalho Arquivo Descricao 
table PermissaoMenuTipo cols: PermissaoMenuTipoId Nome Role Tipo Descricao RelatorioDescricao Arquivo 
table PlanejamentoAlimentadorConjunto cols: PlanejamentoAlimentadorConjuntoId SubEstacaoId AlimentadorId ConjuntoId PlanejamentoEstudoId 
table PlanejamentoComponente cols: PlanejamentoComponenteId Nome ValorUnitario PlanejamentoComponenteUnidadeId PlanejamentoTensaoId PlanejamentoGrupoComponenteId 
table PlanejamentoComponenteUnidade cols: PlanejamentoComponenteUnidadeId Nome 
table PlanejamentoCustoEstimado cols: PlanejamentoCustoEstimadoId Quantidade ValorUnitario PlanejamentoEstudoId PlanejamentoComponenteId Data UsuarioId UsuarioIdExclusao DataExclusao ValorTotal 
table PlanejamentoCustoEstimadoObservacao cols: PlanejamentoCustoEstimadoObservacaoId PlanejamentoEstudoId PlanejamentoCustoEstimadoId HistoricoStatusId Texto Data UsuarioId UsuarioIdExclusao DataExclusao 
table PlanejamentoEstudo cols: PlanejamentoEstudoId Id Serial PlanejamentoPlanoInvestimentoId PlanejamentoTensaoId NotaId Titulo UsuarioId Data PlanejamentoEstudoHistoricoId UnidadeId MunicipioId Descricao FirmaId Justificativa Detalhamento ReferenciaLigador GanhoDec GanhoPerdasAno PlanejamentoTipoObraId CustoEstimado 
table PlanejamentoEstudoAgrupamento cols: PlanejamentoEstudoAgrupamentoId PlanejamentoEstudoId PlanejamentoEstudoIdParceiro 
table PlanejamentoEstudoArquivo cols: ArquivoId PlanejamentoEstudoId 
table PlanejamentoEstudoHistorico cols: PlanejamentoEstudoHistoricoId HistoricoStatusId Observacao UsuarioId Retroagido Excluido PlanejamentoEstudoId Data 
table PlanejamentoEstudoNota cols: PlanejamentoEstudoNotaId PlanejamentoEstudoId NotaId UsuarioId Data UsuarioIdExclusao DataExclusao 
table PlanejamentoEstudoNotaObservacao cols: PlanejamentoEstudoNotaObservacaoId PlanejamentoEstudoId NotaId HistoricoStatusId Texto Data UsuarioId UsuarioIdExclusao DataExclusao 
table PlanejamentoGrupoComponente cols: PlanejamentoGrupoComponenteId Nome 
table PlanejamentoObraAT cols: PlanejamentoObraATId Nome Prazo SetorId PlanejamentoTensaoId 
table PlanejamentoObraATVinculada cols: PlanejamentoObraATVinculadaId PlanejamentoObraATId PlanejamentoEstudoId 
table PlanejamentoPlanoInvestimento cols: PlanejamentoPlanoInvestimentoId Nome 
table PlanejamentoTensao cols: PlanejamentoTensaoId Valor PlanejamentoTipoTensaoId 
table PlanejamentoTipoObra cols: PlanejamentoTipoObraId Nome 
table PlanejamentoTipoTensao cols: PlanejamentoTipoTensaoId Nome 
table Plano cols: PlanoId Id Nome FirmaId DataInicio DataFim Serial 
table PlanoAcao cols: PlanoAcaoId Id Nome PlanoFamiliaId DataPrevisaoInicio DataPrevisaoFim FisicoPrevisto InvestimentoPrevisto Serial 
table PlanoAcaoAvanco cols: PlanoAcaoAvancoId PlanoAcaoId DataReferencia FisicoRealizado InvestimentoRealizado Data UsuarioId DataValidacao UsuarioIdValidacao DataRejeicao UsuarioIdRejeicao 
table PlanoAcaoConjunto cols: PlanoAcaoConjuntoId PlanoAcaoId ConjuntoId 
table PlanoAcaoObservacao cols: PlanoAcaoObservacaoId PlanoAcaoId Texto Data UsuarioId 
table PlanoAcaoProjeto cols: PlanoAcaoProjetoId PlanoAcaoId ProjetoId 
table PlanoFamilia cols: PlanoFamiliaId Id Nome PlanoGrupoId PlanoFamiliaTipoId UnidadeMedidaId ComValidacao Prioridade AvancoAutomatico Serial 
table PlanoFamiliaTipo cols: PlanoFamiliaTipoId Nome 
table PlanoFamiliaUsuario cols: PlanoFamiliaUsuarioId PlanoFamiliaId UsuarioId Tipo 
table PlanoGrupo cols: PlanoGrupoId Id Nome PlanoId Serial 
table PosicaoInvestimento cols: PosicaoInvestimentoId Id Descricao Tipo Grupo UnidadeId ContaRazao FirmaId Exercicio 
table Postagem cols: PostagemId Descricao PosicaoInvestimentoTipo IsAtesto IsPrivado Ativo IsServicoComercial RejeitarObservacaoPadrao ZMM244Texto SolicitarNotaFiscal SolicitarFabricaConcreto SolicitarOrdem SolicitarGseOcorrencia SolicitarViatura SolicitarMunicipio SolicitarSgsiPermissaoServico Fracionado IsParcial SolicitarSubEstacao SolicitarOrigemDestino SolicitarMunicipioOrigem SolicitarMunicipioDestino SolicitarDistancia SolicitarPeso SolicitarPedidoTransferencia SolicitarOrdemFornecimento FirmaId 
table PostagemMedicaoGrupo cols: PostagemMedicaoGrupoId Id Serial Data UsuarioId TipoCriacao FirmaId 
table ProgramacaoBoletimComponente cols: ProgramacaoBoletimComponenteId Nome Fracionado Ordem 
table ProgramacaoCarteiraCriterio cols: ProgramacaoCarteiraCriterioId Nome 
table ProgramacaoCarteiraJustificativa cols: ProgramacaoCarteiraJustificativaId Nome Substituir 
table ProgramacaoCarteiraTipo cols: ProgramacaoCarteiraTipoId Nome 
table Projeto cols: ProjetoId Titulo ProjetoTipoId PosicaoInvestimentoId UnidadeId OrgaoExecutor MunicipioId StatusUsuarioId DtZps09 StatusProjetoId EmpresaId NotaId DtContDef DtEngzDef DtUnit DtEngzSin DtConcDef DtConcSin TipoInstalacaoId VlUnit StatusFlutuanteId VlProjeto SaneaId RespEnceConsistenciaUsuarioId RespEnceConsistenciaData RespEnceAnalise1UsuarioId RespEnceAnalise1Data RespEnceAnalise2UsuarioId RespEnceAnalise2Data RespEnceAnaliseCadastroUsuarioId RespEnceAnaliseCadastroData ArquivoTipologiaStatusId DtPriMM QBRRArquivoTipologiaId PostePriPrev PosteSecPrev KMPriPrev KMSecPrev PostePriReal PosteSecReal KMPriReal KMSecReal VLMatPrev VLMdoPrev ArquivoTipologiaId ArquivoTipologiaStatusIdQBRR SaneaAICId ProjetoNumero ProjetoMascara ProjetoText DtUltMM DataCriacao FirmaId DtCanc ResponsavelCarteiraProgramacaoUsuarioId ResponsavelCarteiraProgramacaoData ResponsavelCarteiraFiscalizacaoUsuarioId ResponsavelCarteiraFiscalizacaoData ResponsavelEnvioPastaEncerramentoUsuarioId ResponsavelEnvioPastaEncerramentoData SaneaIdFrenteAtuacao DataAtualizacao ProjetoGrupoItemId ValorOrcado Cups StatusProjetoData StatusUsuarioData ProjetoStatusTipoIdSP ProjetoStatusTipoIdSU ProjetoStatusTipoIdSF ProjetoIdMedidor ProjetoIdKit Situacao SAPCodigo FirmaIdentificadorId Latitude Longitude 
table ProjetoAIC cols: ProjetoId Data Valor 
table ProjetoArquivo cols: ArquivoId ProjetoId QBRRData QBRRDataExclusao 
table ProjetoClienteConectado cols: ProjetoId B1Residencial B2Rural B3Comercial Total 
table ProjetoDemandaProgramacao cols: ProjetoDemandaProgramacaoId Id Serial ProjetoId DemandaProgramacaoTipoId Observacao Data UsuarioId DataProcessando UsuarioIdProcessando DataBaixa UsuarioIdBaixa MotivoBaixa DataRejeicao UsuarioIdRejeicao MotivoRejeicao 
table ProjetoEletrobras cols: ProjetoId EletrobrasTrancheId EletrobrasTrancheTipoId ReferenciaLocalizacao Assentamento QntConsumidores QntKitInterno Observacao ProjetoEletrobrasHistoricoId 
table ProjetoEletrobrasHistorico cols: ProjetoEletrobrasHistoricoId ProjetoId EletrobrasHistoricoStatusId Data UsuarioId Observacao 
table ProjetoEletrobrasModulo cols: ProjetoEletrobrasModuloId ProjetoId EletrobrasModuloId Quantidade 
table ProjetoEletrobrasUC cols: ProjetoId Numero 
table ProjetoEmpresaContrato cols: ProjetoEmpresaContratoId ProjetoId EmpresaContrato TipoServicoId 
table ProjetoEncerramentoOnline cols: ProjetoId EmpresaContratoId EncerramentoOnlineBaseId EncerramentoOnlineAtividadeId EncerramentoOnlineClasseId Fase1 Fase2 Fase3 ProjetoEncerramentoOnlineHistoricoId Zerado 
table ProjetoEncerramentoOnlineAnalise cols: ProjetoEncerramentoOnlineAnaliseId ProjetoId ServicoAtividadeId MaterialId QuantidadeAjuste Justificativa Validado Quantidade 
table ProjetoEncerramentoOnlineComponente cols: ProjetoEncerramentoOnlineComponenteId ProjetoId EncerramentoOnlineComponenteId Quantidade 
table ProjetoEncerramentoOnlineFolha cols: ProjetoEncerramentoOnlineFolhaId ProjetoEncerramentoOnlineComponenteId Numero Quantidade 
table ProjetoEncerramentoOnlineHistorico cols: ProjetoEncerramentoOnlineHistoricoId ProjetoId HistoricoStatusId Data UsuarioId 
table ProjetoEncerramentoOnlineMedicaoFinal cols: ProjetoEncerramentoOnlineMedicaoFinalId ProjetoId ServicoAtividadeId Quantidade FatorK Valor ItemCodigo 
table ProjetoEncerramentoOnlineObservacao cols: ProjetoEncerramentoOnlineObservacaoId ProjetoId Texto Data UsuarioId 
table ProjetoEnvioPasta cols: ProjetoEnvioPastaId Id Serial ProjetoId Observacao Data UsuarioId DataResponsavel UsuarioIdResponsavel DataBaixa UsuarioIdBaixa ObservacaoBaixa DataCancelado UsuarioIdCancelado MotivoCancelado HistoricoStatusId 
table ProjetoEnvioPastaItem cols: ProjetoEnvioPastaItemId ProjetoEnvioPastaId EnvioPastaItemId Selecionado HistoricoStatusId Observacao 
table ProjetoEnvioPastaResumo cols: ProjetoId ProjetoEnvioPastaId ProjetoEnvioPastaIdPenultimo 
table ProjetoEstudoAmbiental cols: ProjetoEstudoAmbientalId Id Serial ProjetoId FirmaId Data UsuarioId ProjetoEstudoAmbientalHistoricoId 
table ProjetoEstudoAmbientalAcao cols: ProjetoEstudoAmbientalAcaoId ProjetoEstudoAmbientalId Id EmpresaAtendimentoId EmpresaAtendimentoData UsuarioAtendimentoId UsuarioAtendimentoData EmpresaValidacaoId EmpresaValidacaoData UsuarioValidacaoId UsuarioValidacaoData Serial ProjetoEstudoAmbientalAcaoTipoId ProjetoEstudoAmbientalAcaoHistoricoId 
table ProjetoEstudoAmbientalAcaoArquivo cols: ArquivoId ProjetoEstudoAmbientalAcaoId 
table ProjetoEstudoAmbientalAcaoBioma cols: ProjetoEstudoAmbientalAcaoBiomaId Nome 
table ProjetoEstudoAmbientalAcaoChecklist cols: ProjetoEstudoAmbientalAcaoChecklistId ProjetoEstudoAmbientalAcaoId Selecionado Observacao ProjetoEstudoAmbientalAcaoChecklistItemId 
table ProjetoEstudoAmbientalAcaoChecklistItem cols: ProjetoEstudoAmbientalAcaoChecklistItemId Nome ProjetoEstudoAmbientalAcaoTipoId Ordem 
table ProjetoEstudoAmbientalAcaoEnquadramentoAto cols: ProjetoEstudoAmbientalAcaoEnquadramentoAtoId Nome Sigla 
table ProjetoEstudoAmbientalAcaoEstudo cols: ProjetoEstudoAmbientalAcaoId InventarioFlorestal AptoLiberacao ProjetoEstudoAmbientalAcaoEnquadramentoAtoId ProjetoEstudoAmbientalAcaoVegetacaoId ProjetoEstudoAmbientalAcaoBiomaId 
table ProjetoEstudoAmbientalAcaoHistorico cols: ProjetoEstudoAmbientalAcaoHistoricoId ProjetoEstudoAmbientalAcaoId HistoricoStatusId Observacao Data UsuarioId Retroagido Excluido 
table ProjetoEstudoAmbientalAcaoObservacao cols: ProjetoEstudoAmbientalAcaoObservacaoId ProjetoEstudoAmbientalAcaoId HistoricoStatusId Texto Data UsuarioId 
table ProjetoEstudoAmbientalAcaoOcorrencia cols: ProjetoEstudoAmbientalAcaoId ProjetoEstudoAmbientalAcaoOcorrenciaTipoId ProjetoEstudoAmbientalAcaoEnquadramentoAtoId ProjetoEstudoAmbientalAcaoIdProcesso 
table ProjetoEstudoAmbientalAcaoOcorrenciaTipo cols: ProjetoEstudoAmbientalAcaoOcorrenciaTipoId Nome Sigla 
table ProjetoEstudoAmbientalAcaoOrgao cols: ProjetoEstudoAmbientalAcaoOrgaoId Nome Sigla 
table ProjetoEstudoAmbientalAcaoParecer cols: ProjetoEstudoAmbientalAcaoParecerId Nome 
table ProjetoEstudoAmbientalAcaoPostagem cols: ProjetoEstudoAmbientalAcaoId 
table ProjetoEstudoAmbientalAcaoProcesso cols: ProjetoEstudoAmbientalAcaoId Requerimento Processo ProjetoEstudoAmbientalAcaoOrgaoId ProjetoEstudoAmbientalAcaoParecerId DataAberturaRequerimento DataAberturaProcesso 
table ProjetoEstudoAmbientalAcaoTipo cols: ProjetoEstudoAmbientalAcaoTipoId Nome 
table ProjetoEstudoAmbientalAcaoVegetacao cols: ProjetoEstudoAmbientalAcaoVegetacaoId Nome NomeArvore Ordem ProjetoEstudoAmbientalAcaoVegetacaoIdParente 
table ProjetoEstudoAmbientalHistorico cols: ProjetoEstudoAmbientalHistoricoId ProjetoEstudoAmbientalId HistoricoStatusId Data Observacao UsuarioId Retroagido Excluido 
table ProjetoEstudoAmbientalObservacao cols: ProjetoEstudoAmbientalObservacaoId ProjetoEstudoAmbientalId HistoricoStatusId Texto Data UsuarioId 
table ProjetoEtiqueta cols: ProjetoEtiquetaId ProjetoId EtiquetaId Data 
table ProjetoEtiquetaResumo cols: ProjetoId Etiquetas 
table ProjetoFormularioVisitaCampoAIC cols: ProjetoFormularioVisitaCampoAICId Id ProjetoId UsuarioIdFiscal DataVisita EmpresaId EmpresaInativa FormularioVisitaCampoSituacaoAICId FormularioVisitaCampoAcaoAICId SituacaoDetalhes AplicadoPostes AplicadoRedeAT AplicadoRedeBT AplicadoTrafos ClientesLigadosRegular LigacoesClandestinas ClientesNaoIndicadosProjeto ClientesNaoIndicadosProjetoQuant ZonaUrbana Data UsuarioId DataRejeicao UsuarioIdRejeicao MotivoRejeicao Serial FormularioVisitaCampoDetalhamentoSituacaoAICId 
table ProjetoFormularioVisitaCampoAICEquipamento cols: ProjetoFormularioVisitaCampoAICEquipamentoId ProjetoFormularioVisitaCampoAICId Item 
table ProjetoFormularioVisitaCampoAICResumo cols: ProjetoId ProjetoFormularioVisitaCampoAICId 
table ProjetoGrupo cols: ProjetoGrupoId Nome FirmaId 
table ProjetoGrupoItem cols: ProjetoGrupoItemId Nome ProjetoGrupoId Manutencao 
table ProjetoGseProjetoResumo cols: ProjetoId GseProjetoId 
table ProjetoInconformidadeEMFZ cols: ProjetoInconformidadeEMFZId ProjetoId InconformidadeEMFZId Observacao Data UsuarioId DataBaixa UsuarioIdBaixa Excluido 
table ProjetoJogo cols: ProjetoJogoId ProjetoId TipoJogoId JogoMovimentoId JogoStatusId ReservaA ReservaB Data UsuarioId DataBaixa UsuarioIdBaixa Centro 
table ProjetoMaterialServicoPrevisto cols: ProjetoMaterialServicoPrevistoId ProjetoId ElementoPEPId Data UsuarioId DataAtualizacao UsuarioIdAtualizacao Atual 
table ProjetoMaterialServicoPrevistoItem cols: ProjetoMaterialServicoPrevistoItemId ProjetoMaterialServicoPrevistoId MaterialId ServicoAtividadeId Valor Quantidade ClasseCustoId MaterialCentro 
table ProjetoMovimentacao cols: ProjetoMovimentacaoId Numero Linha ProjetoId ElementoPEPId DataDocumento DataLancamento Quantidade Valor TipoDocumento UsuarioId ClasseCustoId EmpresaContratoId ContratoItem Pedido PedidoItem DocumentoReferencia DocumentoReferenciaExercicio DocumentoReferenciaLinha ServicoAtividadeId MaterialId MaterialJogoMovimentoId MaterialCentro MaterialDeposito MaterialLote MaterialReserva Folha Data MaterialRecebedorId 
table ProjetoMovimentacaoLinha cols: ProjetoMovimentacaoLinhaId ProjetoMovimentacaoId Linha LinhaExterno ServicoAtividadeId Quantidade ValorBruto ValorLiquido ValorPago 
table ProjetoMovimentacaoReservaSanea cols: ProjetoMovimentacaoId MaterialRecebedorId Justificativa Data UsuarioId 
table ProjetoObservacao cols: ProjetoObservacaoId ProjetoId Tipo Texto UsuarioId Data ProjetoPostagemId 
table ProjetoPedido cols: ProjetoPedidoId ProjetoId Pedido PedidoTipoServicoId PedidoTipoMedicaoId Data UsuarioId DataAlocacao UsuarioIdAlocacao Excluido Valor ProjetoPostagemPedidoId 
table ProjetoPEP cols: ProjetoPEPId ProjetoId ElementoPEPId SAPCodigo Titulo Nivel Excluido MunicipioId ProjetoGrupoItemId DataCriacao DataAtualizacao 
table ProjetoPEPResumo cols: ProjetoPEPId ValorBruto ValorLiquido ValorMop ValorServico ValorMaterial ValorObrigacaoEspecial 
table ProjetoPostagem cols: ProjetoPostagemId Id ProjetoId PostagemId Data UsuarioId DataAtesto UsuarioIdAtesto DataValidacao UsuarioIdValidacao DataPedido UsuarioIdPedido DataRecepcao UsuarioIdRecepcao NotaFiscal FabricaConcretoId EmpresaContrato Arquivado FaturamentoZRMId MunicipioId Serial DataRejeicao UsuarioIdRejeicao PostagemMedicaoGrupoId PostagemMedicaoGrupoIdCriacao MedicaoOrigemDestinoId MunicipioIdOrigem MunicipioIdDestino Distancia PedidoTransferencia OrdemFornecimento IsAtesto Status 
table ProjetoPostagemPedido cols: ProjetoPostagemPedidoId ProjetoPostagemId Pedido 
table ProjetoPostagemServico cols: ProjetoPostagemServicoId ProjetoPostagemId ServicoAtividadeId Quantidade FatorK QuantidadeValidada Valor ValorFinal ValorFinalValidada FaturamentoZRMGrupoAcaoItemId ItemCodigo GseOcorrenciaId Viatura SgsiPermissaoServicoId Ordem SubEstacao Peso 
table ProjetoProgramacaoBoletimProdutividade cols: ProjetoProgramacaoBoletimProdutividadeId ProjetoId ProgramacaoBoletimComponenteId Instalado Desativado DataExecucao UsuarioIdEncarregado Data UsuarioId DataSaidaBase DataChegadaObra DataInicioAPR DataFimAPR DataInicioAtividadeCampo DataFimAtividadeCampo DataChegadaBase 
table ProjetoProgramacaoCarteira cols: ProjetoProgramacaoCarteiraId Id Serial ProgramacaoCarteiraTipoId UnidadeId ProjetoId Carteira Previsao ProgramacaoCarteiraCriterioId Data ProjetoProgramacaoCarteiraHistoricoId DataPrevisaoFim DataPrevisaoInicio 
table ProjetoProgramacaoCarteiraHistorico cols: ProjetoProgramacaoCarteiraHistoricoId ProjetoProgramacaoCarteiraId HistoricoStatusId Data UsuarioId ProjetoProgramacaoCarteiraIdDePara DataPrevisaoFim DataPrevisaoInicio Previsao ProgramacaoCarteiraCriterioId 
table ProjetoProgramacaoCarteiraObservacao cols: ProjetoProgramacaoCarteiraObservacaoId ProjetoProgramacaoCarteiraId Texto HistoricoStatusId Data UsuarioId ProgramacaoCarteiraJustificativaId 
table ProjetoRecurso cols: ProjetoRecursoId ProjetoId Valor Data UsuarioId DataAlocacao UsuarioIdAlocacao Excluido StatusUsuarioId ProgramacaoCarteira 
table ProjetoResumo cols: ProjetoId ValorBruto ValorLiquido ValorMop ValorServico ValorMaterial ValorObrigacaoEspecial 
table ProjetoRevisaoOrcamento cols: ProjetoId ProjetoRevisaoOrcamentoHistoricoId RevisaoOrcamentoJustificativaId 
table ProjetoRevisaoOrcamentoHistorico cols: ProjetoRevisaoOrcamentoHistoricoId ProjetoId HistoricoStatusId Data UsuarioId 
table ProjetoRevisaoOrcamentoItem cols: ProjetoRevisaoOrcamentoItemId ProjetoId MaterialId Quantidade QuantidadeAjuste QuantidadeAnalise JustificativaAnalise Validado 
table ProjetoRevisaoOrcamentoObservacao cols: ProjetoRevisaoOrcamentoObservacaoId ProjetoId HistoricoStatusId Texto Data UsuarioId 
table ProjetoServicoDesconto cols: ProjetoServicoDescontoId Id ProjetoId ServicoDescontoTipoId EmpresaContratoFornecedorId Notificacao Documento Data UsuarioId DataDesconto UsuarioIdDesconto DataRejeicao UsuarioIdRejeicao MotivoRejeicao DataProcessando UsuarioIdProcessando ArquivoId Serial 
table ProjetoServicoDescontoItem cols: ProjetoServicoDescontoItemId ProjetoServicoDescontoId ContaContabil Valor ElementoPEPId MaterialId ServicoAtividadeId Quantidade 
table ProjetoSgsiSolicitacaoIntervencaoResumo cols: ProjetoId SgsiSolicitacaoIntervencaoId 
table ProjetoStatus cols: ProjetoId ProjetoStatusTipoId Data UsuarioId ProjetoStatusId DataExclusao UsuarioIdExclusao Flutuante 
table ProjetoStatusTipo cols: ProjetoStatusTipoId Nome Sigla Grupo Ordem Prioridade Icone Cor 
table ProjetoTermoGeo cols: ProjetoTermoGeoId Id Serial ProjetoId GseProjetoId SgsiSolicitacaoIntervencaoId ArquivoIdAsbuilt Data ProjetoTermoGeoHistoricoId 
table ProjetoTermoGeoChecklist cols: ProjetoTermoGeoChecklistId ProjetoTermoGeoId TermoGeoChecklistId Observacao 
table ProjetoTermoGeoHistorico cols: ProjetoTermoGeoHistoricoId ProjetoTermoGeoId HistoricoStatusId Data UsuarioId Excluido GseProjetoStatusId Retroagido 
table ProjetoTermoGeoObservacao cols: ProjetoTermoGeoObservacaoId ProjetoTermoGeoId Texto HistoricoStatusId Data UsuarioId Retroagido 
table ProjetoTermoGeoResumo cols: ProjetoId ProjetoTermoGeoId 
table ProjetoTipo cols: ProjetoTipoId Nome 
table ProjetoXStatusFlutuante cols: ProjetoId StatusFlutuanteId Data 
table ProtocoloMulta cols: ProtocoloMultaId Id ProtocoloMultaTipoId Valor SaldoResidual PosicaoInvestimentoId ProtocoloNotificacaoId ReferenciaNotificacao ProjetoId Nota Titulo UsuarioIdNotificador DataDocumento EmpresaContratoFornecedorId UnidadeId MunicipioId Observacao ObservacaoReprovar Data ProtocoloMultaHistoricoId FirmaId Serial 
table ProtocoloMultaArquivo cols: ArquivoId ProtocoloMultaId 
table ProtocoloMultaHistorico cols: ProtocoloMultaHistoricoId ProtocoloMultaId HistoricoStatusId Valor DocumentoNotaCredito DocumentoSAP Data UsuarioId FaturaVinculada 
table ProtocoloMultaTipo cols: ProtocoloMultaTipoId Nome Ordem 
table ProtocoloNotificacao cols: ProtocoloNotificacaoId Id ProtocoloNotificacaoTipoId MultaPrevista PrazoDias PosicaoInvestimentoId ProjetoId Nota Titulo EmpresaContratoFornecedorId UnidadeId MunicipioId Complemento Data ProtocoloNotificacaoHistoricoId FirmaId Serial Prazo 
table ProtocoloNotificacaoArquivo cols: ArquivoId ProtocoloNotificacaoId 
table ProtocoloNotificacaoHistorico cols: ProtocoloNotificacaoHistoricoId ProtocoloNotificacaoId HistoricoStatusId Observacao Data UsuarioId 
table ProtocoloNotificacaoTipo cols: ProtocoloNotificacaoTipoId Nome Texto MultaPrevista PrazoDias ComplementoObrigatorio Ordem Ativo MultaPrevistaObrigatorio 
table ProtocoloNotificacaoUsuario cols: ProtocoloNotificacaoId JobHistoricoNotificacaoEnvioId 
table Recebedor cols: RecebedorId Id Responsavel 
table RenovaveisCluster cols: RenovaveisClusterId Nome Data UsuarioId DataAtualizacao UsuarioIdAtualizacao FirmaId 
table RenovaveisTorre cols: RenovaveisTorreId Nome RenovaveisClusterId ProjetoPEPId Data UsuarioId DataAtualizacao UsuarioIdAtualizacao EstadoId 
table RevisaoOrcamentoJustificativa cols: RevisaoOrcamentoJustificativaId Nome FirmaId 
table Sanea cols: SaneaId Nome Tipo Ordem FirmaId 
table SAPCentro cols: SAPCentroId Numero Nome SAPNome FirmaId SAPLoteId MunicipioId EmpresaId Tipo Latitute Longitude HistoricoStatusId NomeResumo 
table SAPCentroCusto cols: SAPCentroCustoId Codigo FirmaIdentificadorId 
table SAPClasseCusto cols: SAPClasseCustoId Codigo Nome 
table SAPContaRazao cols: SAPContaRazaoId FirmaIdentificadorId Codigo Nome 
table SAPDeposito cols: SAPDepositoId Numero Nome SAPNome SAPCentroId SAPCentroIdFornecedor MunicipioId EmpresaId DataInicio Tipo Latitude Longitude HistoricoStatusId NomeResumo 
table SAPLogon cols: SAPLogonId Conexao Mandante Login Senha DataSenha 
table SAPLote cols: SAPLoteId Nome Servico Material 
table SAPMaterialDocumento cols: SAPMaterialDocumentoId Numero Exercicio SAPMaterialDocumentoTipoOperacaoId DataDocumento DataLancamento DataEntrada UsuarioId Texto 
table SAPMaterialDocumentoItem cols: SAPMaterialDocumentoItemId SAPMaterialDocumentoId Item FirmaId SAPMaterialDocumentoTipoMovimentoId MaterialId Centro Deposito Quantidade Texto ProjetoPEPId SAPPedidoItemId SAPReservaItemId MaterialMovimentoItemId Valor ProjetoId SAPCentroId SAPDepositoId 
table SAPMaterialDocumentoTipoMovimento cols: SAPMaterialDocumentoTipoMovimentoId Codigo Nome 
table SAPMaterialDocumentoTipoOperacao cols: SAPMaterialDocumentoTipoOperacaoId Codigo Nome 
table SAPMovimento cols: SAPMovimentoId Numero Exercicio SAPMovimentoOperacaoId SAPMovimentoTipoId DataDocumento DataLancamento DataEntrada UsuarioId Texto Valor 
table SAPMovimentoItem cols: SAPMovimentoItemId SAPMovimentoId Item Periodo ProjetoPEPId SAPClasseCustoId SAPContaRazaoId SAPCentroCustoId SAPMovimentoOrdemId EmpresaIdentificacaoId Quantidade Valor ServicoAtividadeId MaterialId UnidadeMedidaId FirmaIdentificadorId SAPPedidoItemId SAPPedidoItemLinhaId SAPMaterialDocumentoItemId 
table SAPMovimentoItemLinha cols: SAPMovimentoItemLinhaId SAPMovimentoItemId Linha LinhaExterno ServicoAtividadeId Quantidade ValorBruto ValorLiquido ValorPago 
table SAPMovimentoOperacao cols: SAPMovimentoOperacaoId Sigla Nome 
table SAPMovimentoOrdem cols: SAPMovimentoOrdemId Codigo Nome FirmaIdentificadorId 
table SAPMovimentoTipo cols: SAPMovimentoTipoId Sigla Nome 
table SAPParceiroFuncao cols: SAPParceiroFuncaoId Codigo Nome Ordem 
table SAPPedido cols: SAPPedidoId FirmaId Numero SAPPedidoTipoId HistoricoStatusId EmpresaId Data OrganizacaoCompra LiberacaoGrupo LiberacaoEstrategia LiberacaoStatus GrupoCompra DataAtualizacao 
table SAPPedidoClasseContabil cols: SAPPedidoClasseContabilId SAPPedidoItemId Sequencia Eliminado Quantidade Distribuicao ValorLiquido ContaRazao ProjetoPEPId 
table SAPPedidoCondicaoTipo cols: SAPPedidoCondicaoTipoId Aplicacao Codigo Nome 
table SAPPedidoHistorico cols: SAPPedidoHistoricoId SAPPedidoId HistoricoStatusId Data UsuarioId 
table SAPPedidoItem cols: SAPPedidoItemId SAPPedidoId Item HistoricoStatusId MaterialId Texto EmpresaContratoId ContratoItem Quantidade UnidadeMedidaId ValorLiquido Peso UnidadeMedidaIdPeso Centro Deposito CategoriaClasseContabil GrupoMercadoria CategoriaItem TipoEstoque CodigoImposto RemessaFinal SAPRequisicaoCompraItemId 
table SAPPedidoItemCondicao cols: SAPPedidoItemCondicaoId SAPPedidoItemId Posicao SAPPedidoCondicaoTipoId Regra Montante Ativo 
table SAPPedidoItemLinha cols: SAPPedidoItemLinhaId SAPPedidoItemId Linha LinhaExterno Eliminado ServicoAtividadeId Texto Quantidade UnidadeMedidaId ValorLiquido ValorBruto 
table SAPPedidoItemLinhaCondicao cols: SAPPedidoItemLinhaCondicaoId SAPPedidoItemLinhaId Posicao SAPPedidoCondicaoTipoId Regra Montante Ativo 
table SAPPedidoTipo cols: SAPPedidoTipoId Codigo Nome 
table SAPRequisicaoCompraItem cols: SAPRequisicaoCompraItemId Numero Item SAPRequisicaoCompraTipoId FirmaId FirmaIdentificadorId 
table SAPRequisicaoCompraTipo cols: SAPRequisicaoCompraTipoId Codigo Nome 
table SAPReserva cols: SAPReservaId FirmaId Numero 
table SAPReservaItem cols: SAPReservaItemId SAPReservaId Item 
table ServicoAtividade cols: ServicoAtividadeId Codigo Descricao Mercadoria TarifaFiscal LancamentoAtesto CentroCusto FaturamentoZRMItemServicoId UnidadeMedidaId FaturamentoZRMTipoServicoId ServicoAtividadeIdZRMNovo ZRMCancelado EncerramentoOnlineFamiliaId EncerramentoOnlineAtividadeId PagamentoCTE CadernoServicoId TransporteConcretoAtivo TransporteConcretoPavimentado TransporteConcretoValorFixo TransporteConcretoFaixaDe TransporteConcretoFaixaAte ExpansaoManutencao InstalacaoDevolucao ServicoAtividadeToneladaId 
table ServicoAtividadeItem cols: ServicoAtividadeItemId ServicoAtividadeId Data Valor EmpresaContrato FaturamentoZRMItemServicoId 
table ServicoAtividadeTonelada cols: ServicoAtividadeToneladaId Nome FirmaId 
table ServicoDescontoTipo cols: ServicoDescontoTipoId Nome Ordem Assunto 
table Sessao cols: SessaoId Identificador UsuarioId DataInicio DataFim Mobile 
table Setor cols: SetorId Descricao Sigla FirmaId 
table SgsiPermissaoServico cols: SgsiPermissaoServicoId SgsiSolicitacaoIntervencaoId Data ServicoConcluido Serial 
table SgsiSolicitacaoIntervencao cols: SgsiSolicitacaoIntervencaoId Data ProjetoId DataCriacao DataAnalise DataAprovacao DataReprovacao DataCancelada DataConclusao DataEncerrada SgsiStatusId Serial DataStatus 
table SgsiStatus cols: SgsiStatusId Nome 
table SgsiTermo cols: SgsiTermoId SgsiSolicitacaoIntervencaoId SgsiTermoStatusId Observacao Data UsuarioId UsuarioIdResponsavel DataStatus UsuarioIdStatus MotivoStatus Serial 
table SgsiTermoStatus cols: SgsiTermoStatusId Nome Sigla 
table SituacaoFaturamento cols: SituacaoFaturamentoId Descricao Identificador 
table StatusFlutuante cols: StatusFlutuanteId Nome Sigla Ordem Prioridade 
table StatusProjeto cols: StatusProjetoId Descricao Sigla 
table StatusUsuario cols: StatusUsuarioId Descricao Sigla 
table SubEstacao cols: SubEstacaoId Codigo Nome ConjuntoId 
table TemaFestivo cols: TemaFestivoId Nome 
table TemaFestivoPeriodo cols: TemaFestivoPeriodoId TemaFestivoId Dia Mes Ano 
table TermoGeoChecklist cols: TermoGeoChecklistId Nome SolicitarObservacao 
table TermosLGPD cols: TermosLGPDId Texto DataInicio 
table TipoInstalacao cols: TipoInstalacaoId Descricao Sigla 
table TipoJogo cols: TipoJogoId Descricao Ordem 
table TipoObra cols: TipoObraId Nome Filtro TipoObraGrupoId 
table TipoObraGrupo cols: TipoObraGrupoId Nome Sigla Ordem FirmaId 
table TipoServico cols: TipoServicoId Nome 
table TurmaCampo cols: TurmaCampoId Nome Codigo TurmaCampoTipoId Data UsuarioId EmpresaId FirmaId Ativo 
table TurmaCampoTipo cols: TurmaCampoTipoId Nome 
table TurmaCampoUsuario cols: TurmaCampoUsuarioId TurmaCampoId UsuarioId Tipo DataAdicionado UsuarioIdAdicionado DataExcluido UsuarioIdExcluido 
table Unidade cols: UnidadeId Descricao Sigla DepartamentoId MunicipioId Nome 
table UnidadeMedida cols: UnidadeMedidaId Sigla Fracionado Nome 
table UnidadeMeta cols: UnidadeMetaId Nome ParenteUnidadeMetaId Ano Valor1 Valor2 Valor3 Valor4 Valor5 Valor6 Valor7 Valor8 Valor9 Valor10 Valor11 Valor12 
table UnidadeMetaOrgaoExecutor cols: UnidadeMetaOrgaoExecutorId UnidadeMetaId OrgaoExecutor 
table Usuario cols: UsuarioId Login Senha Email Nome Criado Telefone Celular DataSenha BotWhatsapp BotTelegram BotTelegramId Chave ChaveValidade BotTeams BotTeamsId Aceito NomeParaResumo NomeIniciais TemaEscuro Login2 SenhaTentativas NomeResumo 
table UsuarioEndereco cols: UsuarioId Cep Logradouro Numero Complemento Bairro CidadeId PontoReferencia 
table UsuarioEstadoCivil cols: UsuarioEstadoCivilId Nome 
table UsuarioFuncao cols: UsuarioFuncaoId Nome PodeAutoCadastrar PermissaoTipo FirmaId Identificador 
table UsuarioFuncaoPermissao cols: UsuarioFuncaoId PermissaoId 
table UsuarioGX cols: UsuarioId EmpresaId EmpresaFiltro UsuarioIdSupervisor Setor Cargo Localidade RedeCADAtualizado Ativo DataPerfil 
table UsuarioJobNotificacao cols: UsuarioJobNotificacaoId UsuarioId JobNotificacaoId Telegram Whatsapp Email Teams 
table UsuarioLog cols: UsuarioLogId UsuarioId UsuarioLogTipoId Texto Data IdentificadorGuid IdentificadorLong 
table UsuarioLogTipo cols: UsuarioLogTipoId Titulo Proprio ModalTamanho 
table UsuarioMenuFavorito cols: UsuarioMenuFavoritoId UsuarioId PermissaoId Nome Ordem FirmaId 
table UsuarioPermissao cols: UsuarioId PermissaoId UsuarioPermissaoId FirmaId 
table UsuarioPF cols: UsuarioId RG RGEstadoId DataNascimento UsuarioSexoId UsuarioEstadoCivilId 
table UsuarioPJ cols: UsuarioId RazaoSocial 
table UsuarioPJRepresentante cols: UsuarioPJRepresentanteId UsuarioId Nome CPF 
table UsuarioSenha cols: UsuarioSenhaId UsuarioId Senha Data 
table UsuarioSexo cols: UsuarioSexoId Nome 
table UsuarioTermosLGPD cols: UsuarioTermosLGPDId UsuarioId TermosLGPDId Data Aceito 
table UsuarioUsuarioFuncao cols: UsuarioUsuarioFuncaoId UsuarioId UsuarioFuncaoId DataValidade DataAdicionado UsuarioIdAdicionado ChamadoIdAdicionado DataRevogado UsuarioIdRevogado ChamadoIdRevogado 
table UsuarioXUnidade cols: UsuarioId UnidadeId 
table VersionInfo cols: Version AppliedOn Description 
